"1111111111",
"1000000001",
"1000000001",
"1001000101",
"1000000101",
"1001000001",
"1001000001",
"1001000111",
"1000000001",
"1111111111",
