R"(
%%%%%%%%%%%%%%%%%%%%
%        @@        %
%        @@        %
%  #   # @@        %
%      # @@        %
%  #               %
%  #     @@        %
%  #   ##@@        %
%        @@        %
%%%%%%%%%%%%%%%%%%%%
)"
