R"(
11111111111111111111
10000000011000000001
10000000011000000001
10010001011000000001
10000001011000000001
10010000000000000001
10010000011000000001
10010001111000000001
10000000011000000001
11111111111111111111
)"
